###########
#        O#
# ###  PXX#
#O      # #
# # #     #
###########