##########
#    P   #
#    X   #
#    O   #
##########