##############
#    O#OX   O#
#  #### #    #
# PX  #      #
#     #X     #
#            #
##############
